NO assets/tex/xpm42/redbrick.xpm42
SO assets/tex/xpm42/mossy.xpm42
EA assets/tex/xpm42/bluestone.xpm42
WE assets/tex/xpm42/eagle.xpm42

F 42,23,35
C 5,44,70

11111111111111111111111111111111111111111111111111111111111111111111111111111111111111111111111111111111111111111111111111111111111111111111111111111111111111111111111111
1W000000000000000000000000000000000000000000000000000000000000000000000000000000000000000000000000000000000000000000000000000000000000000000000000000000000000000000000001
11111111111111111111111111111111111111111111111111111111111111111111111111111111111111111111111111111111111111111111111111111111111111111111111111111111111111111111111111
