NO    assets/tex/xpm42/bluestone.xpm42
WE         			assets/tex/xpm42/redbrick.xpm42
SO   assets/tex/xpm42/greystone.xpm42
EA 			assets/tex/xpm42/wood.xpm42

C      0,128,255
F        128,128,128

        1111111111111111111111111
        1000000000110000000000001

        101100000111000000S000001

        1001000000000000000000001
111111111011000001110000000000001
100000000011000001110111111111111
11110111111111011100000010001

11110111111111011101010010001
11000000110101011100000010001
10000000000100001100000010001    
10000000000000001101010010001


1100000111010101111101111000111  
11110111 1110101 10111101000001  
10000001 1111111 11111111111111
10000001         1010101010011
10101111        	1110100000101
10101011        	1110101001001



10101111        	1110100000101
1111111111111111111111111111111
