NO assets/tex/eagle.xpm
SO assets/tex/eagle.xpm
WE assets/tex/eagle.xpm
EA assets/tex/eagle.xpm

F 102,51,0
C 0,128,255

        1111111111111111111111111
        1000000000110000000000001
        101100000111000000N000001
        1001000000000000000000001
111111111011000001110000000000001
100000000011000001110111111111111
11110111111111011100000010001    
11110111111111011101010010001    
11000000110101011100000010001    
10000000000100001100000010001    
10000000000000001101010010001    
1100000111010101111101111000111  
11110111 1110101 10111101000001  
11111111 1111111 11111111111111