NO assets/tex/xpm42/redbrick.xpm42
SO assets/tex/png/Emoji.png
EA assets/tex/png/Dices.png
WE assets/tex/png/Drole.png

F 42,23,35
C 5,44,70

111111111
1N0000001
111111111
